0000000000000000000000000000000000000000
0000000000000000000000000000000000000000
0000000000000000000000000000000000000000
0000000000000000000000000000000000000000
0000001111111111100000011111111111000000
0000001110001111100000011111111111000000
0000001111111111100000010001111111000000
0000001111011111100000011101111111000000
0000001110000011100000011100000111000000
00000011101s1x1110000001110sx11111000000
0000001110000011100000010100000111000000
0000001110111111100000010111111111000000
0000001111111111100000010111100011000000
0000001000111111100000011111111111000000
0000001011111111100000011111111111000000
0000000000000000000000000000000000000000
0000000000000000000000000000000000000000
0000000000000000000000000000000000000000
0000000000000000000000000000000000000000
0000000000000000000000000000000000000000