000000000000000000000000000000000000000000000
000000000000000000000000000000000000000000000
000000000000000000000000000000000000000000000
000000001111111000000000000000111111100000000
000000111110111110000000000011111111111000000
000001111110111111000000000110111111101100000
000011111110111111100000001111011111011110000
000s11111110111111110000011111101110111111000
001111111111111111111000111111110101111111100
001010101010101010101000111111111011111111100
00111111111x1111111110001111111111x1111111100
000111111110111111110000011111111011111111000
000011111110111111100000001111110101111110000
000001111110111111000000000111101110111s00000
000000111110111110000000000011111111111000000
000000001111111000000000000000111111100000000
000000000000000000000000000000000000000000000
000000000000000000000000000000000000000000000
000000000000000000000000000000000000000000000
000000000000000000000000000000000000000000000