000000000000000000000000000000000000000000000
000000000000000000000000000000000000000000000
000000000000000000000000000000000000000000000
000000001011111000000000000000111111100000000
000000111011111110000000000011111111111000000
000001111011111111000000000111111000011000000
000010101011111111100000001111111011011110000
0001s01010111111x1110000011111111011011111000
001110101011000001111000111111111011011100000
001110101111001111111000111000010011111111100
001110101111001111111000111111000111111111100
000110101111001111110000011111sx1111111111000
000011101111001111100000001111111111111110000
000001101111001111000000000000000011111100000
000000101111111110000000000011111111111000000
000000001111111000000000000000111111100000000
000000000000000000000000000000000000000000000
000000000000000000000000000000000000000000000
000000000000000000000000000000000000000000000
000000000000000000000000000000000000000000000