0000000000000000000000000000000000000000
0000000000000000000000000000000000000000
0000000000000000000000000000000000000000
0000000000000000000000000000000000000000
0000000000111000000000000001110000000000
0000000001111100000000000011111000000000
0000000011111110000000000111111100000000
0000000111111111000000001111111110000000
0000001111101111100000011111011111000000
00000011s1101x11100000011s1101x111000000
0000001111101111100000011111011111000000
0000000111111111000000001111111110000000
0000000011111110000000000111111100000000
0000000001111100000000000011111000000000
0000000000111000000000000001110000000000
0000000000000000000000000000000000000000
0000000000000000000000000000000000000000
0000000000000000000000000000000000000000
0000000000000000000000000000000000000000
0000000000000000000000000000000000000000