000000000000000000000000000000000000000000000
000000000000000000000000000000000000000000000
000000000000000000000000000000000000000000000
000000001111111000000000000000111111100000000
000000111111111110000000000011111111111000000
000001111111111111000000000111111111111100000
000011110111111111100000000011001100001100000
000111110111111111110000010011001100000000000
001111110001000000011000111100111111111111100
00111111010101111x01100011110011111x111111100
00111100010001111101100011s111001100111111100
00011s101111111000010000011111001100111111000
000011101111111111100000001111111100111110000
000001100000111111000000000111111100111100000
000000111111111110000000000011111111111000000
000000001111111000000000000000111111100000000
000000000000000000000000000000000000000000000
000000000000000000000000000000000000000000000
000000000000000000000000000000000000000000000
000000000000000000000000000000000000000000000