000000000000000000000000000000000000000000000
000000000000000000000000000000000000000000000
000000000000000000000000000000000000000000000
000000001111111000000000000000111111100000000
00000011111s111110000000000011111111111000000
000000000001111111100000000111111111111100000
0000111111111111111000000011s1111111111110000
000111111111111111110000000000000000111111000
000000011111100000000000111111111111111111100
00111111111111111111100011111x111111111111100
001111111111111111111000111111111101111111100
000111110000111100000000011111111101111111000
000011111111111111100000001111111111111110000
0000011x1111111111000000000111110000011100000
000000111111111110000000000011111111111000000
000000001111111000000000000000111111100000000
000000000000000000000000000000000000000000000
000000000000000000000000000000000000000000000
000000000000000000000000000000000000000000000
000000000000000000000000000000000000000000000