0000000000000000000000000000000000000000
0000000000000000000000000000000000000000
0000000000000000000000000000000000000000
0000000000000000000000000000000000000000
0000001111111101100000011111111111000000
0000001111111101100000011011111011000000
0000001111100001100000011111111111000000
00000011111111011000000111111x1111000000
0000001111111101100000011110010001000000
00000000011s110x100000011110111111000000
0000001111111101100000011110111111000000
0000001110000101100000011110111111000000
00000011111111011000000111s0111111000000
0000001111111101100000000011111111000000
0000001111111111100000011111111111000000
0000000000000000000000000000000000000000
0000000000000000000000000000000000000000
0000000000000000000000000000000000000000
0000000000000000000000000000000000000000
0000000000000000000000000000000000000000