0000000000000000000000000000000000000000
0000000000000000000000000000000000000000
0000000000000000000000000000000000000000
0000000000000000000000000000000000000000
0000001111111111100000011111x11111000000
0000001111111111100000011111111111000000
0000001100001111100000011111000000000000
0000001111111111100000011111111111000000
0000001101111100000000011111111111000000
0000001111x11111100000011111111011000000
0000001111111111100000010000111011000000
0000001111111011100000011111111011000000
0000000000011011100000011111111011000000
0000001111111011100000011s10111111000000
0000001s11111011100000011110111111000000
0000000000000000000000000000000000000000
0000000000000000000000000000000000000000
0000000000000000000000000000000000000000
0000000000000000000000000000000000000000
0000000000000000000000000000000000000000