000000000000000000000000000000000000000000000
000000000000000000000000000000000000000000000
000000000000000000000000000000000000000000000
000000001111111000000000000000111111100000000
000000111111111110000000000011111111111000000
000001111111111111000000000111111111111100000
000011111111111111100000001111111111111110000
00011111s000111111110000011111111111111111000
001111110010011111111000111111111000x11111100
001111110111011111111000111111110010011111100
001111110010011111111000111111110111011111100
000111111000x11111110000011111110010011111000
00001111111111100000000000111111s000111110000
000001111111011111000000000111011111111100000
000000111111011110000000000011011111011000000
000000001111011000000000000000011111000000000
000000000000000000000000000000000000000000000
000000000000000000000000000000000000000000000
000000000000000000000000000000000000000000000
000000000000000000000000000000000000000000000