000000000000000000000000000000000000000000000
000000000000000000000000000000000000000000000
000000000000000000000000000000000000000000000
011111111111111111111110111111111111111111110
011s11111110011111111110111111111111111111s10
011111111001100111111110111111000110001111110
011111100111111001111110111110111111110111110
011110011111111110011110111101111111111011110
011001111111111111100110111011111111111101110
011111111111111111111110110111111111111110110
011001111111111111100110111011111111111101110
011110011111111110011110111101111111111011110
011111100111111001111110111110111111110111110
011111111001100111111110111111000110001111110
0111111111100111111x1110111x11111111111111110
011111111111111111111110111111111111111111110
000000000000000000000000000000000000000000000
000000000000000000000000000000000000000000000
000000000000000000000000000000000000000000000