0000000000000000000000000000000000000000
0000000000000000000000000000000000000000
0000000000000000000000000000000000000000
0000000000000000000000000000000000000000
0000000000111000000000000001110000000000
0000000001111100000000000011111000000000
0000000011111110000000000101111100000000
0000000111110111000000001111111010000000
0000001111111111100000011110111111000000
0000001011s10x101000000011x01s1111000000
0000001111111111100000011111111111000000
0000000111111111000000001111101110000000
0000000011111110000000000111111100000000
0000000001101100000000000011011000000000
0000000000111000000000000001110000000000
0000000000000000000000000000000000000000
0000000000000000000000000000000000000000
0000000000000000000000000000000000000000
0000000000000000000000000000000000000000
0000000000000000000000000000000000000000