000000000000000000000000000000000000000000000
000000000000000000000000000000000000000000000
000000000000000000000000000000000000000000000
000000001111111000000000000000111111100000000
000000111000001110000000000011111101111000000
000001110111111111000000000111110001111100000
000011101111111111100000001101111110111110000
000111011101111101110000011011111111011111000
001110111011111101111000111011111111100011100
00111011011s111101111000111111111s11101111100
001110111011111101111000111111111111101110000
00011101111111101111000001x111011111011111000
000011101111110111100000001111100000111110000
000001111111001x11000000000111111111111100000
000000111111111110000000000011110111111000000
000000001111111000000000000000101111100000000
000000000000000000000000000000000000000000000
000000000000000000000000000000000000000000000
000000000000000000000000000000000000000000000
000000000000000000000000000000000000000000000