0000000000000000000000000000000000000000
0000000000000000000000000000000000000000
0000000000000000000000000000000000000000
0000000000000000000000000000000000000000
0000000000111000000000000001110000000000
0000000001111100000000000011111000000000
0000000011111110000000000111101100000000
0000000100111111000000001111101s10000000
0000001111111111100000011111011111000000
0000001101110x111000000011x1111111000000
0000001111110000100000011111111011000000
00000001s1111111000000001110111010000000
0000000011111110000000000111111000000000
0000000001111100000000000011111000000000
0000000000111000000000000001110000000000
0000000000000000000000000000000000000000
0000000000000000000000000000000000000000
0000000000000000000000000000000000000000
0000000000000000000000000000000000000000
0000000000000000000000000000000000000000