000000000000000000000000000000000000000000000
000000000000000000000000000000000000000000000
000000000000000000000000000000000000000000000
000000001011111000000000000000111111100000000
000000111011111110000000000011111111111000000
000001111011111111000000000111111111111100000
000011111011111111000000001111111111111110000
000111111011111111010000011111111111111111000
001111111011111110111000111111111111111111100
001101111111100001111000111111111s1x111111100
00110111111110x111111000111111110000011111110
000101111s11101111110000011111111111111111000
000001111111101111100000001111111111111110000
000001111011101111000000000111111111111100000
000000111011111110000000000011111111111000000
000000001011111000000000000000111111100000000
000000000000000000000000000000000000000000000
000000000000000000000000000000000000000000000
000000000000000000000000000000000000000000000
000000000000000000000000000000000000000000000