00000000000000000000000000000000000000000000000000000000
00000000000000000000000000000000000000000000000000000000
00000000000000000000000000000000000000000000000000000000
00s111111111111111111111110000s1111111111111111111111100
00111111111111111111111111000011111111111111111111111100
00110011001100110011100111000011111111111111111111111100
00110011001100110011100111000011111111111111111111111100
00111100111111001111111111000011111111111111111111111100
00111100111111001111111111000011111111111111111111111100
00110011001100110011100111000011111111111111111111111100
00110011001100110011100111000011111111111111111111111100
00111111111111111111111111000011111111111111111111111100
00111111111111111111111111000011111111111111111111111100
00111100111111001111100111000011111111111111111111111100
00111100111111001111100111000011111111111111111111111100
00111111111111111111111111000011111111111111111111111100
00000000000000000000000000000000000000000000000000000000
00000000000000000000000000000000000000000000000000000000
00000000000000000000000000000000000000000000000000000000