0000000000000000000000000000000000000000
0000000000000000000000000000000000000000
0000000000000000000000000000000000000000
0000000000000000000000000000000000000000
0000001101111111100000011111101111000000
0000001101111101100000011111s01111000000
0000001111111101100000011111101x11000000
0000001111111101100000011100001111000000
0000001111101101100000011101111111000000
00000011s1101x11100000011111111111000000
0000001101101111100000011111111100000000
0000001101101111100000000110111111000000
0000001101101111100000011111011111000000
0000001101111101100000011111100111000000
0000001101111101100000011111111111000000
0000000000000000000000000000000000000000
0000000000000000000000000000000000000000
0000000000000000000000000000000000000000
0000000000000000000000000000000000000000
0000000000000000000000000000000000000000