000000000000000000000000000000000000000000000
000000000000000000000000000000000000000000000
000000000000000000000000000000000000000000000
001111111111111111111111001111111111111111100
001111111111111111111111001111111111111111100
001110011111111111110011001110000000011111100
00111001111110111111001100110011s111001111100
00111001111110x111110011001111111111100111100
001110011110000011110011001111111111100111100
001110011111s01111110011001111111100011111100
001110011111101111110011001111100011111111100
001110011111111111110011001100000000000x11100
001111111111111111111111001111111111111111100
001111111111111111111111001111111111111111100
001111111111111111111111001111111111111111100
001111111111111111111111001111111111111111100
000000000000000000000000000000000000000000000
000000000000000000000000000000000000000000000
000000000000000000000000000000000000000000000