0000000000000000000000000000000000000000
0000000000000000000000000000000000000000
0000000000000000000000000000000000000000
0000000000000000000000000000000000000000
0000001111111011100000011111101111000000
0000001101111011100000011111101111000000
000000110111101110000001111x101111000000
0000001101101111100000011100001111000000
0000001101101111100000011101111111000000
0000001111101111100000011101111111000000
0000001111000011100000011001111111000000
0000001111011111100000011000000111000000
0000001111011111100000011111110111000000
000000111s011x11100000011111111s11000000
0000001111011111100000011111111111000000
0000000000000000000000000000000000000000
0000000000000000000000000000000000000000
0000000000000000000000000000000000000000
0000000000000000000000000000000000000000
0000000000000000000000000000000000000000