0000000000000000000000000000000000000000
0000000000000000000000000000000000000000
0000000000000000000000000000000000000000
0000000000000000000000000000000000000000
0000001111111111100000011111111111000000
0000001101111111100000011111111001000000
0000001000111111100000011111111001000000
0000001101111111100000011111111111000000
0000001111111111100000011111111111000000
00000011111s1x1110000001111sx11111000000
0000001111111111100000011111111111000000
0000001111111101100000011111111111000000
0000001111111000100000010011111111000000
0000001111111101100000010011111111000000
0000001111111111100000011111111111000000
0000000000000000000000000000000000000000
0000000000000000000000000000000000000000
0000000000000000000000000000000000000000
0000000000000000000000000000000000000000
0000000000000000000000000000000000000000