0000000000000000000000000000000000000000
0000000000000000000000000000000000000000
0000000000000000000000000000000000000000
0000000000000000000000000000000000000000
0000001111111111100000011111111111000000
0000001111111111100000011100001111000000
0000001111011111100000011111101111000000
0000001111011111100000011111101111000000
0000001111000001100000011111101111000000
0000001111111x011000000111x1101111000000
0000001111111101100000011111111111000000
0000000000000001100000011011111111000000
0000001101111111100000011011111111000000
0000001s0111111110000001s011111111000000
0000001111111111100000011011111111000000
0000000000000000000000000000000000000000
0000000000000000000000000000000000000000
0000000000000000000000000000000000000000
0000000000000000000000000000000000000000
0000000000000000000000000000000000000000